1 1 1 1 1 1 1 1 1 1 1 1 1 1 1 1 1 1 1 1 1 1 1 1 1 1 1 1 1 1 1 1 1 1 1 1 1 1 1 1 1 1 1 1 1 1 1 1 1 1 1
1 1 1 1 1 1 1 1 1 1 1 1 1 1 1 1 1 1 1 1 1 1 1 1 1 1 1 1 1 1 1 1 1 1 1 1 1 1 1 1 1 1 1 1 1 1 1 1 1 1 1
1 1 1 2 2 2 2 1 1 1 1 1 1 1 1 1 2 2 2 2 2 R 2 1 1 1 1 1 1 1 1 1 1 1 1 1 1 1 1 1 1 1 1 1 1 1 1 1 1 1 1
1 1 1 2 2 2 R 2 1 1 1 1 1 1 1 2 R 2 2 2 R 2 2 2 1 1 1 1 1 1 1 1 1 1 1 1 1 1 1 1 1 1 1 1 1 1 1 1 1 1 1
1 1 1 2 R 2 2 2 2 2 2 1 1 2 2 2 2 0 0 0 0 0 2 2 2 1 1 1 1 1 1 1 1 1 1 1 1 1 1 1 1 1 1 1 1 1 1 1 1 1 1
1 1 1 2 2 2 2 0 2 2 2 2 2 2 2 2 0 W W W W W 0 2 2 1 1 1 1 1 1 1 1 1 1 1 1 1 1 1 1 1 1 1 1 1 1 1 1 1 1
1 1 1 2 2 2 0 T 0 0 2 2 0 0 T 0 0 W 2 G 2 W 0 0 2 2 2 1 1 1 1 1 1 1 1 1 1 1 1 1 1 1 1 1 1 1 1 1 1 1 1
1 1 1 1 2 R 2 0 2 0 B 0 0 0 0 0 0 W 2 2 2 W 0 0 0 2 2 2 2 2 2 1 1 1 1 1 1 1 1 1 1 1 1 1 1 1 1 1 1 1 1
1 1 1 1 2 2 2 2 0 0 0 0 0 0 0 0 0 W W D W W 0 T 0 0 0 0 2 R 2 2 2 2 1 1 1 1 1 1 1 1 1 1 1 1 1 1 1 1 1
1 1 1 1 1 1 2 2 2 2 0 0 0 B 0 0 0 0 0 0 0 0 0 0 0 0 0 0 0 0 0 0 2 2 2 1 1 1 1 2 2 2 2 1 1 1 1 1 1 1 1
1 1 1 1 1 1 1 2 2 2 2 0 0 0 0 0 0 T 0 0 0 0 B 0 0 0 0 1 1 1 0 0 0 2 2 1 1 1 2 2 2 B B B 1 1 1 1 1 1 1
1 1 1 1 1 1 1 1 2 R 2 0 0 0 0 0 0 0 0 0 0 0 0 0 0 0 1 1 1 1 0 0 2 2 2 1 1 2 2 B B 0 0 K B 1 1 1 1 1 1
1 1 1 1 1 1 1 1 1 2 2 0 T 0 0 0 0 0 0 0 0 0 0 0 0 0 0 1 1 1 1 0 2 2 1 1 2 2 B 0 0 0 B B 2 2 1 1 1 1 1
1 1 1 1 1 1 1 1 2 2 2 0 0 0 0 0 0 0 0 0 0 0 0 B 0 0 K 0 1 1 1 0 0 2 2 2 2 B B B 0 0 0 0 B 2 1 1 1 1 1
1 1 1 1 1 1 1 2 2 2 0 0 0 0 0 B 0 0 0 0 0 0 0 0 0 0 0 0 0 1 0 0 0 2 B B B 0 0 0 B 0 B B 2 1 1 1 1 1 1
1 1 1 1 1 1 2 2 2 0 B 0 0 0 0 0 0 0 0 0 0 T 0 0 0 0 0 0 0 0 0 0 0 B B 0 0 B B 0 0 0 B 0 2 2 1 1 1 1 1
1 1 1 1 1 2 2 2 0 W W W W W W W 0 0 0 0 0 0 0 0 0 0 T 0 0 0 0 0 0 B 0 0 B 0 0 0 B B 0 2 2 2 1 1 1 1 1
1 1 1 1 1 2 R 2 0 W 2 2 2 2 2 W 0 0 0 0 0 0 0 B 0 0 0 0 0 0 0 0 0 0 B 0 0 0 0 B 0 0 2 2 2 1 1 1 1 1 1
1 1 1 1 2 2 2 0 W W W W W W 2 W 0 T 0 0 0 0 0 0 0 0 0 0 0 0 0 0 0 0 B 0 B B 0 B 0 2 2 2 1 1 1 1 1 1 1
1 1 1 1 2 2 2 0 W 2 W W 2 2 2 2 0 0 0 0 0 0 0 0 0 0 0 0 0 0 0 0 0 0 0 0 0 0 B 0 2 2 2 1 1 1 1 1 1 1 1
1 1 1 2 2 2 2 2 W 2 2 2 2 W W W 0 0 0 0 0 0 0 0 0 0 0 0 0 0 0 0 0 0 0 B B 0 B 2 2 2 1 1 1 1 1 1 1 1 1
1 1 1 2 R 2 2 2 W W 2 W W W 0 0 0 0 0 B 0 0 0 0 0 0 0 0 0 0 0 0 0 0 0 0 B B 2 2 2 1 1 1 1 1 1 1 1 1 1
1 1 1 2 2 2 2 2 2 W K W 0 0 0 T 0 0 0 0 0 0 0 0 0 0 0 0 0 0 0 0 2 2 2 2 2 2 2 2 1 1 1 1 1 1 1 1 1 1 1
1 1 1 2 2 2 2 R 2 W W W 2 2 0 0 0 2 2 2 0 2 2 2 2 R 2 2 0 K 0 2 2 2 2 2 2 2 2 1 1 1 1 1 1 1 1 1 1 1 1
1 1 1 1 2 2 2 2 2 2 2 1 R 2 2 2 2 2 2 2 2 R 2 2 2 2 2 2 2 0 0 2 2 2 1 1 1 1 1 1 1 1 1 1 1 1 1 1 1 1 1
1 1 1 1 1 1 1 1 1 1 1 1 1 2 2 2 2 2 1 2 2 2 1 1 1 1 1 1 2 2 0 2 2 1 1 1 1 1 1 1 1 1 1 1 1 1 1 1 1 1 1
1 1 1 1 1 1 1 1 1 1 1 1 1 1 1 1 1 1 1 1 1 1 1 1 1 1 1 1 1 2 2 2 1 1 1 1 1 1 1 1 1 1 1 1 1 1 1 1 1 1 1
1 1 1 1 1 1 1 1 1 1 1 1 1 1 1 1 1 1 1 1 1 1 1 1 1 1 1 1 1 1 1 1 1 1 1 1 1 1 1 1 1 1 1 1 1 1 1 1 1 1 1